20 20
0S000000010000100001
01111111111111110111
01001000000000011101
11101011011101000001
01001001110101111111
01011100010000100101
11010111010111110101
00000100011100000100
11110111110111111111
10100100000010000000
10101111111111011110
10100100001010010010
10111101101010111010
10000100111010000010
11110110101111111111
10000100101000000101
11111111111111111101
10000000000000001001
10111111111111111111
100E0000000000000001