S010010010
1110100101
001000E010
0011111101
0000001010
1001010100
0010101001
0101010010
1010100100
0101001000