2
S010010010
1110100101
001000E010
0011111101
0000001010
1001010100
0010101001
0101010010
1010100100
0101001000
1010010010
1S10100101
0010000010
0011111101
0000001010
1001011100
0010101001
0101011010
1010100110
010100100E
	
